1111111111
1P0C0000E1
1000000001
10000000001
1111111111
