1111111111
1P0C0000E1
10000000C1
10000000001
1111111111
