1111111111111111
1P000000000000C1
1000000000000001
1001111111111001
1001        1001
1001111111111001
10000000000000E1
1111111111111111
